111111
100001
100001
11CE11
111111